XXXXXXXXXXXXXXX
XXXXXXXXXXXXXXX
XX---XXXXX---XX
XX-P-XXXXX-G-XX
XX---XXXXX---XX
XXXX-XXXXX-XXXX
XXXX-XXXXX-XXXX
XXXX-------XXXX
XXXX---T---XXXX
XXXXXXXXXXXXXXX