XXXXXXXXXXXXXXX
XXXXXXXXXXXGXXX
XX---XXXXX---XX
XX-P-XXX---M-XX
XX---XXXXX---XX
XXX--XX--X--XXX
XXX--XX--X--XXX
XXX---------XXX
XXX---------XXX
XXXXXXXT-XXXXXX
XXXXXXX--XXXXXX
XXXXXXXXXXXXXXX